#################
#.........#.....#
#...#######.....#
#........##..####
#...###.........#
#..#............#
#...............#
#...........#...#
#...........#...#
#...........#...#
#...........#...#
#......######...#
#...............#
#...............#
#################
