#################
#.........#.....#
#...#######.....#
#........##..####
#...###.........#
#...###.........#
#...............#
#...............#
#.....#####.....#
#.....#####.....#
#...............#
#...............#
#...............#
#...............#
#################
